┌──────────────────────────────────────────────────────────────────────────────┐
│                    │    │      ┌───────────┐    ┌───────┐  ┌──────────┐      │
│                    │    │     ┌┘           │   ┌┘      ?└──┘          └─┐    │
│        ┌────────┐  │    │     │            └┐  │                        │    │
│     ┌──┘        └──┘    │     │      C      │  │                        │    │
│    ┌┘                   │     │       .     │  │     ┌─────────┐    E   │    │
│    │                    │     └┐            │  ├──-──┤         │        │    │
│ ┌──┘                    └┐     └─┐          │  │     └─────┐   └┐      ┌┘    │
│ │                        │       └────┐     │  │           └─┐  └──────┘     │
│ └┐                       └┐           ├──-──┤  │            .│               │
│  │?.                      └───────────┘     │  └┐            │               │
│  └────┐                                     │   │            │               │
│       └┐                                    │  ┌┘           ┌┘               │
│        │   ┌────┐                         ┌─┘  │           ┌┘   ┌─────┐      │
│        └───┘    └──────────────┐    ┌─────┘    │    ┬──────┘   ┌┘E.   └─┐    │
│    ┌────┐                      │    │  ┌────┐  ├─   └┐         │        │    │
│──┬─┘    └──┐    ┌───────┬──────┘    └──┘    └──┘     └────────┬┘        │    │
│. │         └────┘       │                                               │    │
│  |E                     │                                               │    │
│  │                                                            │         │    │
│──┴─┐    ┌──────┐    ┌───┴────┐       ┌─────┐    ┌──────┐    ┌─┴───┐     │    │
│    │    │      └────┘        └─┐    ┌┘     └────┘      └────┘     └┐    │    │
│    │   ┌┘                      │    └──────────────┐               │.?  │    │
│    └───┘                      ┌┘                   └┐              └────┘    │
│                               │                     └┐                       │
│                     ┌──────┐  │                      └────┐                  │
│                    ┌┘.     │  └┐     ┌─┐    ┌─┐           └─┐                │
│          ┌────┐    │       └┐  │    ┌┘ └────┘ └┐            │                │
│     ┌────┘    └────┘        └──┴─-──┤          │            │                │
│    ┌┘                               │          │            │                │
│    │                                └┐ ┌────┐ ┌┘            │                │
│    │                                 └─┘    └─┘           ┌─┘                │
│    └──┐  E       ┌─────┐    ┌─┐                      ┌────┘                  │
│       └┐        ┌┘     └────┘ └┐                    ┌┘                       │
│        │       .│              │                   ┌┘                        │
│        └────────┘              │      ┌────────────┘                         │
│                                │?   ┌─┘                                      │
│                                ├──-─┤                                        │
│                                │    │                                        │
└──────────────────────────────────────────────────────────────────────────────┘