┌──────────────────────────────────────────────────────────────────────────────┐
│                                    │    │                                    │
│                                    │    │                           ┌─┴──│   │
│                                    │    │                           │   ?│   │
│                                    │    │                           │─┐ ┌┘   │
│                                    │    │                             │ │    │
│                                  ┌─┘    └─┐                          ┌┘ │    │
│                              ┌───┘        └───┐                     ┌┘  │    │
│                            ┌─┘                └─┐                  │┘  ┌┘    │
│                           ┌┘                    └┐                 │  ┌│     │
│                     ┌─────┘                      └─────┐           │ ┌┘      │
│                    ┌┘                                  └┐          │ ├       │
│                   ┌┘                                    └┐         │ │       │
│               ┌───┘                     ┌┐     ?         └───┐     │ └┐      │
│             ┌─┘                         └┘     ──            └─┐   ┤  └│     │
│            ┌┘                                                  └┐  └┐  └┐    │
│            │      ┌─┐                                  ┌┐       │   │┐  └┐   │
│            │      │ │                                  └┘       │    └┐  └│  │
│           ┌┘      └─┘                                           └┐    └┐  │  │
│          ┌┘                                                      └┐    └┐ └┐ │
│         ┌┘                   │?                                   └┐    │  │ │
│        ┌┘       ──                                         │       └┐   │┐ │ │
│        │                                                   │        │    │ │ │
│        │                                      ┌┐.                   │    │ │ │
│        │     ┌┐?                              └┘?                   │    │ ├ │
│        │     └┘?                                                    │    │ │ │
│        │                      │                                     │    │ │ │
│        └┐                                                          ┌┘    ┤ │ │
│         └┐                                                        ┌┘    ┌┘ │ │
│          └┐           ┌┐                                         ┌┘    │┘  │ │
│           └┐          ││                      │                 ┌┘    ┌┘  ┌┘ │
│            │          └┘                                ┌─┐     │    ┌┘  ┌┘  │
│            │                          E                 └─┘     │   │┘  ┌┘   │
│            └┐                                                  ┌┘  ┌┘  ┌│    │
│             └─┐                 ──                           ┌─┘  ┌┘  ┌┘     │
│               └───┐                                      ┌┐ ┌┴──┴─┘  ┌┘      │
│                   └┐                                    ┌┘│          │       │
│                    └─┐               .                ┌─┘ │────────┬─│       │
│                      └────────────────────────────────┘                      │
└──────────────────────────────────────────────────────────────────────────────┘