┌──────────────────────────────────────────────────────────────────────────────┐
│  ┌──────────┐   ┌──────────┐     ┌──────────┐          ┌─────────────────────│
│┌─┘          │  ┌┘         ?└┐  ┌─┘          │       ┌──┘                     │
││            │  │            │  │            │      ┌┘         ┌┐             │
││       .   ┌┘  │           ┌┘  │          ┌─┘      │          └┘             │
│└───┐    ┌──┘   └───┐    ┌──┘   └───┐    ┌─┘        │                    ┌────│
│    ├─-──┤  ┌────┐  ├──-─┤  ┌────┐  ├──-─┤          │                    │    │
│    │    └──┘    └──┘    └──┘    └──┘    │        ┌─┘                    │    │
│    │                                    │        │    ┌─┐     E         │    │
│    │                                 E  │        │    └─┘               │    │
│    └─┐            .?┌──┐               ┌┘        │                 ┌┐   │    │
│      └─────┐    ┌───┘  └───┐    ┌──────┘         │                 └┘   │    │
│            │    │          │    │                │                     ┌┘    │
│     ┌──────┘    └───┐  ┌───┘    └──────┐         └──┐                ?┌┘     │
│    ┌┘               └──┘               └┐           └──────┐    ┌─────┘      │
│    │                                    │                  ├─-──┤            │
│    │                                    │        ┌─────────┘    └──────┐     │
│    │    ┌──────────┐    ┌──────────┐    │      ┌─┘        .     ?      └┐    │
│    │    │          ├─-──┤          ├──-─┤      │                        │    │
│ ┌──┘    │       ┌──┘    └───┐  ┌───┘    └──┐   │                        │    │
│┌┘       │       │     E     │  │           └┐  │     ┌─────────────┐    │    │
││        │      ┌┘          ┌┘  │            │  │    ┌┘             │    │    │
││       ┌┘      │          .│   └─┐         ?│  │    │             ┌┘    │    │
││    ┌──┘       └───────────┘     └──────────┘  ├──-─┤             │     │    │
│├─  ─┤     ┌──┐                         ┌────┐  │    │             │     │    │
││?   └─────┘C └─┐             ┌─────────┘    └──┘    │             │     └┐   │
││               │           ┌─┘                      │             └┐     │   │
││               └┐          │                        │              │     │   │
││                └──────────┘                       ┌┘   ┌──────┐   │     │   │
││      ┌──┐                          ┌──┐    ┌──────┘   ┌┘.     └┐  │    ┌┘   │
││     ┌┘  └┐                         │  │    │          │        │  │    │    │
││    ┌┘    └┐                       ┌┘  ├─-──┤       ┌──┘        └─┬┘    │    │
││    └┐    ┌┘    ┌──┐    ┌──────────┘   │    │       │             │     │    │
││     └┐  ┌┘     │  └────┘              │    └┐      │             |     │    │
││      └──┘      └┬─────┐           ┌───┘     └──┐   └┐            │    ┌┘    │
││                 │?    └┐          │            │    └─┐         ┌┴────┘     │
││                 |      │          │           C│      │?.      ┌┘           │
│└─┐               │      │          └┐        E┌─┘      └───┐    │            │
│  └───────────────┴─┐    │           └─────────┘            └────┘            │
└──────────────────────────────────────────────────────────────────────────────┘