┌──────────────────────────────────────────────────────────────────────────────┐
├─────────────────┐ ┌───────────┐                    ┌──────────┐              │
│                 └─┘           └┐                  ┌┘          └┐             │
│                  .             └┐                 │            └┐            │
│                          ┌┐     │                ┌┘             └──────┐     │
├────┐       ┌┐            └┘     │                │                    ?│     │
│    │       ││                   │                │  E                  └┐    │
│    │       └┘                   └─┬────┐         │                      │    │
│    └┐                             │    │         └┐             ┌──┐    │    │
│     │                                  └┐         │             │  │    │    │
│    ┌┘                 ┌─┐         │     │         └─┐  ?       ┌┘  ├─  ─┤    │
│    │                  └─┘       ┌─┴┐    │           └──────────┘   │    │    │
│    │                            │  │    │                          │    │    │
│    │    ┌──┐                    │ ┌┘    │                          │    └┐   │
│    │    └──┘                    │ │     │                          │     │   │
│    │C                           │ │     │                          └┐    │   │
│    └─┐                       ┌──┘ │     └┐                          │    │   │
│      └───────────────────────┘    └┐     │                          │    │   │
│                                    │     │                         ┌┘    │   │
│                                    │     │                         │     │   │
│                                    │    ┌┘                         │    ┌┘   │
│            ┌────────┐              │    │              ┌────────┐  ├─  ─┤    │
│     ┌──────┘        └──────────────┘    └──────────────┘        └──┘    │    │
│    ┌┘                                                                   │    │
│    │                                                                    │    │
│    │          ┌──┐                                        ┌──┐          │    │
│    │    ┌─────┘  └─────┐    ┌──────┐    ┌──────┐    ┌─────┘  └─────┐    │    │
│    ├─ ──┤              ├─-──┤      └────┘      ├─-──┤              ├─-──┤    │
│  ┌─┘    └──┐         ┌─┘?   └──┐            ┌──┘    └──┐         ┌─┘    └──┐ │
│ ┌┘         │       ┌─┘         └┐          ┌┘          │       ┌─┘         │ │
│┌┘          └┐      │            │          │           └┐      │           └┐│
││            │      │            │        ┌─┤            │      │            ││
││            │      │            │        │.             │      │            ││
││            │      │           ┌┘        └─┤            │      │            ││
│└──┐        ┌┘      └┐          │           └─┐         ?│      └┐          ┌┘│
│   └┐    ┌──┘        └──┐    ┌──┘             └─┐    ┌───┘       └──┐    ┌──┘ │
│    └────┘              └────┘                  └────┘              └────┘    │
│                                                                              │
│                                                                              │
└──────────────────────────────────────────────────────────────────────────────┘