┌──────────────────────────────────────────────────────────────────────────────┐
│     ┌──────────────┐    ┌────────┬────┐                ┌────┐                │
│    ┌┘              └────┘             └─┐              │   .│                │
│    │                 E                  │              │    │                │
│    │.                                   │           ┌──┘    └───┐            │
│    └───┐    ┌──────┐    ┬──┐    ┌──┐    │          ┌┘           │            │
│        ├─-──┤      │    │  ├──-─┤  │    │          │            │            │
│┌───────┘    └──┐   │    │  │    │  │   ┌┘  ┌────┐  │            ├───────┐    │
││               └┐  ├    │  │    │  └───┘   │    │  │        ┌──┤        │    │
││.               │  └────┘  │   C│          │    │  │        │  │        │    │
│└┐               │          │?  ┌┘       ┌──┘    │  │        │  │      .┌┘    │
│ └──────────┬    │          └───┘       ┌┘       │  └───┐    │  │    ┌──┘     │
│            │    └┐                     │        │      ├──-─┤  ├─  ─┤        │
│  ┌─────────┘     └─────┬───┐           │?       └──────┘    └──┘    │        │
│┌─┘            E            └────┐      └───┐                        │        │
││                                │          │                        └┐       │
││       ┌────┐                   └───┐      └─┐                       └───────│
││    ┌──┘    └──┐    ┬─────┐         │        └─────┐    ┌──────┐             │
│├──-─┤          │    │     └┐        │              ├─-──┤      │             │
││    │  ┌────┐  └┐   │      │        ┴──────────────┘    │   ┌──┘             │
││    │  │    │   └───┘      └───┐                        │  ┌┘           ┌────│
││    │  │   .│                  │     E                  ┤  │            │    │
││.  ┌┘  │   ?└───────┐          │           ┌────┐       │  │            │    │
│└───┘   ├            └┐         └───┬    ┌──┘    └──┐    │  └───┐        │    │
│        │             │             │    │          │    │      │        │    │
│        └┐           ┌┘   ┌─────────┘    │  ┌────┐  │    └───┐  │.      ┌┘    │
│         └──────┐    │  ┌─┘              │  │.   │  │        │  └───────┘     │
│                ├─-──┤  │                │  │    │  │        ┤                │
│     ┌───┐   ┌──┘    └──┘                │  │    └──┘        │                │
│    ┌┘   │  ┌┘               ┌──────┐    │  │            ┬───┘                │
│    │    │  │                │      ├─-──┤  │       E    │                    │
│    │    └──┘                │   ┌──┘    │  └┐           │   ┌──────┐         │
│    │            ┬────┴─┐    │  ┌┘       ┤   └──────┐    │  ┌┘     .│         │
│    │     E      │      │    │  │        │          ├──-─┤  │       └┐        │
│    │           ┌┘      └┐   │  │   E    │          │    └──┘        │        │
│    │    ┌──────┘        └───┘  │        │          │                │        │
│    │    │                      ├─       │          │      ┌───┐     │        │
│    ├──-─┤                      │   .  ┌─┘          └─┐    │   ├─-──┬┘        │
│    │    │                      └──────┘              └──┴─┘   │    │         │
└──────────────────────────────────────────────────────────────────────────────┘